#######################################
# Syntax Coloring Map For Dabble
#######################################

#######################################
# Class Objects(KEYWORD1)
#######################################
Dabble	KEYWORD1
LedControl	KEYWORD1
GamePad	KEYWORD1
Inputs	KEYWORD1
Oscilloscope	KEYWORD1
Terminal	KEYWORD1
PinMonitor	KEYWORD1
Internet	KEYWORD1
Sensor	KEYWORD1
IOT	KEYWORD1
Camera	KEYWORD1
#######################################
# Functions (KEYWORD2)
#######################################
readBrightness	KEYWORD2	RESERVED_WORD
getpinState	KEYWORD2	RESERVED_WORD
getpinNumber	KEYWORD2	RESERVED_WORD
getAngle	KEYWORD2	RESERVED_WORD
getRadius	KEYWORD2	RESERVED_WORD
isStartPressed	KEYWORD2	RESERVED_WORD
isSelectPressed	KEYWORD2	RESERVED_WORD
isCirclePressed	KEYWORD2	RESERVED_WORD
isCrossPressed	KEYWORD2	RESERVED_WORD
isSquarePressed	KEYWORD2	RESERVED_WORD
isTrianglePressed	KEYWORD2	RESERVED_WORD
isLeftPressed	KEYWORD2	RESERVED_WORD
isRightPressed	KEYWORD2	RESERVED_WORD
isUpPressed	KEYWORD2	RESERVED_WORD
isDownPressed	KEYWORD2	RESERVED_WORD
defineServopins	KEYWORD2	RESERVED_WORD
motorControls	KEYWORD2	RESERVED_WORD
getpwm_Motor1	KEYWORD2	RESERVED_WORD
getpwm_Motor2	KEYWORD2	RESERVED_WORD
runMotor1	KEYWORD2	RESERVED_WORD
runMotor2	KEYWORD2	RESERVED_WORD
sendpinsStatus	KEYWORD2	RESERVED_WORD
sendanalogData	KEYWORD2	RESERVED_WORD
sendDigitalData	KEYWORD2	RESERVED_WORD
sendAnalogData	KEYWORD2	RESERVED_WORD
getvalue_Pot1	KEYWORD2	RESERVED_WORD
getvalue_Pot2	KEYWORD2	RESERVED_WORD
getStatus_SlideSwitch1	KEYWORD2	RESERVED_WORD
getStatus_SlideSwitch2	KEYWORD2	RESERVED_WORD
getStatus_TactileSwitch1	KEYWORD2	RESERVED_WORD
getStatus_TactileSwitch2	KEYWORD2	RESERVED_WORD
getdata_Accelerometer_xaxis	KEYWORD2	RESERVED_WORD
getdata_Accelerometer_yaxis	KEYWORD2	RESERVED_WORD
getdata_Accelerometer_zaxis	KEYWORD2	RESERVED_WORD
getdata_Gyroscope_xaxis	KEYWORD2	RESERVED_WORD
getdata_Gyroscope_yaxis	KEYWORD2	RESERVED_WORD
getdata_Gyroscope_zaxis	KEYWORD2	RESERVED_WORD
getdata_Magnetometer_xaxis	KEYWORD2	RESERVED_WORD
getdata_Magnetometer_yaxis	KEYWORD2	RESERVED_WORD
getdata_Magnetometer_zaxis	KEYWORD2	RESERVED_WORD
getdata_Proximity	KEYWORD2	RESERVED_WORD
getdata_Light	KEYWORD2	RESERVED_WORD
getdata_Sound	KEYWORD2	RESERVED_WORD
getdata_Temperature	KEYWORD2	RESERVED_WORD
getdata_Barometer	KEYWORD2	RESERVED_WORD
getdata_GPS_longitude	KEYWORD2	RESERVED_WORD
getdata_GPS_latitude	KEYWORD2	RESERVED_WORD
getangle_Servo1	KEYWORD2	RESERVED_WORD
getangle_Servo2	KEYWORD2	RESERVED_WORD
send_channel_data	KEYWORD2	RESERVED_WORD	
CaptureImage	KEYWORD2	RESERVED_WORD
CameraFlip	KEYWORD2	RESERVED_WORD
CaptureVideo	KEYWORD2	RESERVED_WORD
FlashToggle	KEYWORD2	RESERVED_WORD

#######################################
# Classes (KEYWORD3)
#######################################
Color	KEYWORD3	RESERVED_WORD	
JsonKeyChain	KEYWORD3	RESERVED_WORD
HttpRequest	KEYWORD3	RESERVED_WORD
HttpResponse	KEYWORD3	RESERVED_WORD
FunctionArg	KEYWORD3	RESERVED_WORD


#######################################
# Constants And Literals (KEYWORD2)
#######################################

FROM_DABBLE_FOLDER	LITERAL2	RESERVED_WORD_2
INCLUDE_INTERNET_MODULE	LITERAL2	RESERVED_WORD_2
INCLUDE_OSCILLOSCOPE_MODULE	LITERAL2	RESERVED_WORD_2
INCLUDE_MOTORCONTROL_MODULE	LITERAL2	RESERVED_WORD_2
INCLUDE_PINMONITOR_MODULE	LITERAL2	RESERVED_WORD_2
INCLUDE_DABBLEINPUTS_MODULE	LITERAL2	RESERVED_WORD_2
INCLUDE_GAMEPAD_MODULE	LITERAL2	RESERVED_WORD_2
INCLUDE_IOT_MODULE	LITERAL2	RESERVED_WORD_2
INCLUDE_SENSOR_MODULE	LITERAL2	RESERVED_WORD_2
INCLUDE_TERMINAL_MODULE	LITERAL2	RESERVED_WORD_2
INCLUDE_CAMERA_MODULE	LITERAL2	RESERVED_WORD_2
INCLUDE_LEDCONTROL_MODULE	LITERAL2	RESERVED_WORD_2
CUSTOM_SETTINGS	LITERAL2	RESERVED_WORD_2
               



